#######
#.    #
#.# ###
#.#   #
# #$ ##
# $ @##
#  !###
#.  $##
#######
