#######
#.    #
#.# ###
#.#   #
# #$ ##
# $ @##
#! $###
#.  $##
#######
