;erim_nr01.xsb
      ####
    ###..#
    #  ..#
    # $..#
######  ##
#@     ###
## $ $ $ #
 # $$# # #
 #   !   #
 #########
 
